++++++++++++++++++++++
+___+___++_++_____+___
+_+___+_______+++_+_++
+_+_+__++__++++___+_+__
+++_++++++____+++_+__+
+__________++__++____+
+++++_++++++___+++++_+
+_____+___+++++++__+_
+_+++++++______S_+___+
+________________+_+++
++++++++++++++++++++++
